@@@@@@@@@@@@@@@@@@@@@@@@@@@@@@@@@@@@@@@@@@@@@@@@@@@@@@@@@@@@@@@@@@@@@@@@@@@@@@@@@@@@@@@@@@@@@@@@@@@@@@@@@@@@@@@@@@@@@@@@
@.@........@.....@.@@.@........@.....@.@@.@........@.....@.@@.@........@.....@.@@.@........@.....@....@........@.....@.@
@...@.@.@@...@@@...@@...@.@.@@...@@@...@@...@.@.@@...@@@...@@...@.@.@@...@@@...@@...@.@.@@...@@@...@@...@.@.@@...@@@...@
@@.@@.@.@@@@@@@@@.@@@@.@@.@.@@@@@@@@@.@@@@.@@.@.@@@@@@@@@.@@@@.@@.@.@@@.@@@@@.@@@@.@@.@.@@@@@@@@@.@@@@.@@.@.@@@@@@@@@.@@
@..@..@.......@@...@@..@..@S......@@...@@..@..@.......@@...@@..@..@.......@@...@@..@..@.......@@...@@..@..@.......@@...@
@.@@@@@@@@@@.@@@@.@@@.@@@@@@@@@@.@@@@.@@@.@@@@@@@@@@.@@@@.@@@.@@@@@@@@@@.@@@@.@@@.@@@@@@@@@@.@@@@.@@@.@@@@@@@@@@.@@@@.@@
@.....@@.....@.@..........@@.....@.@...@@.....@@.....@.@...@@.....@@.....@.@..........@@.....@.@...@@.....@@.....@.@...@
@.@.@.@@.@@@@@.@@.@@@.@.@.@@.@@@@@.@@.@@@.@.@.@@.@@@@@.@@.@@@.@.@.@@.@@@@@.@@.@@@.@.@.@@.@@@@@.@@.@@@.@.@.@@.@@@@@.@@.@@
@.@.@.@@.@...@.@@.@@@.@.@.@@.@...@.@...@@.@.@.@@.@...@.@...@@.@.@.@@.@...@.@@.@@@.@.@.@@.@...@.@...@@.@.@.@@.@...@.@...@
@@@.@.@@.@.@...@@...@@@.@.@@.@.@...@@.@@@@@.@.@@.@.@...@@.@@@@@.@.@@.@.@...@@...@@@.@.@@.@.@...@@.@@@@@.@.@@.@.@...@@.@@
@.@.@.@@.@.@.@@@@.@.@.@.@.@@.@.@.@@@@.@@@.@.@.@@.@.@.@@@@.@@@.@.@.@@.@.@.@@@@.@.@.@.@.@@.@.@.@@@@.@@@.@.@.@@.@.@.@@@@.@@
@.@.@.@@.@.@......@.@.@.@.@@.@.@.@....@@@.@.@.@@.@.@.@....@@@.@.@.@@.@.@.@....@.@.@.@.@@.@.@.@....@@@.@.@.@@.@.@.@....@@
@...@.@@...@.@.@@.@@@...@.@@...@.@.@@.@@@...@.@@...@.@.@@.@@@...@.@@...@.@.@@.@@@...@.@@...@.@.@@.@@@...@.@@...@.@.@@.@@
@.@@@.@@@@@@.@.@@..@@.@@@.@@@@@@.@.@@..@@.@@@.@@@@@@.@.@@..@@.@@@.@@@@@@.@.@@..@@.@@@.@@@@@@.@.@@..@@.@@@.@@@@@@.@.@@..@
@.@...@@.....@.@@@@@@.@...@@.....@.@@@@@@.@...@@.....@.@@@@@@.@...@@.....@.@@@@@@.@...@@.....@.@@@@@@.@...@@.....@.@@@@@
@.@@@@@..@@@@@@@@@.@@.@@@@@@.@@@@@@@@@.@@.@@@@@@.@@@@@@@@@.@@.@@@@@..@@@@@@@@@.@@.@@@@@@.@@@@@@@@@.@@.@@@@@@.@@@@@@@@@.@
@....@@@@@@@....@@.@@.@@@@@@.@@@@@@@@@.@@.@@@@@@.@...@@@@@.@@....@@@@@@@....@@.@@.@@@@@@.@@@@@.@@@.@@.@@@@@@.@@@@@@@@@.@
@@@@.......@.@@@@..@@@@@.......@.@@@@..@@@@@.......@.@@@@@.@@@@@.......@.@@@@..@@@@@.......@.@.@@...@@@@.......@.@@@@@.@
@....@@@@@........@@@....@@@@@........@@@....@@@@@.........@@....@@@@@........@@@....@@@@@........@......@@@@@.........@
@@@@@@@@@@.@@@@@@@@@@@@@@@@@@@@@.@@@@@@@@.@@@@@@@@@@@@@@@@.@@@@@@@@@@@.@@@@@@@@@@@@@@@@@@@.@@@@@@@@@@@@@@@@@@@@@@@@@@@.@
@.@........@.....@.@@.@........@.....@.@@.@........@.....@.@@.@........@.....@.@@.@........@.....@.@@.@........@.....@.@
@...@.@.@@...@@@...@@...@.@.@@...@@@...@@...@.@.@@...@@@...@@...@.@.@@...@@@...@@...@.@.@@...@@@...@@...@.@.@@...@@@...@
@@.@@.@.@@@@@@@@@.@@@@.@@.@.@@@.@@@@@.@@@@.@@.@.@@@@@@@@@.@@@@.@@.@.@@@@@@@@@.@@@@.@@.@.@@@@@@@@@.@@@@.@@.@.@@@@@@@@@.@@
@..@..@.......@@...@@..@..@.......@@.......@..@.......@@...@@..@..@.......@@...@@..@..@.......@@....@..@..@.......@@...@
@.@@@@@@@@@@.@@@@.@@@.@@@@@@@@@@.@@@@.@@@.@@@@@@@@@@.@@@@.@@@.@@@@@@@@@@.@@@@.@@@.@@@@@@@@@@.@@@@.@@@.@@@@@@@@@@.@@@@.@@
@.....@@.....@.@...@@.....@@.....@.@...@@.....@@.....@.@...@@.....@@.....@.@...@@.....@@.....@.@...@@.....@@.....@.@...@
@.@.@.@@.@@@@@.@@.@@@.@.@.@@.@@@@@.@@.@@@.@.@.@@.@@@@@.@@.@@@.@.@.@@.@@@@@.@@.@@@.@.@.@@.@@@@@.@@.@@@.@.@.@@.@@@@@.@@.@@
@.@.@.@@.@...@.@...@@.@.@.@@.@...@.@...@@.@.@.@@.@...@.@...@@.@.@.@@.@...@.@...@@.@.@.@@.@...@.@...@@.@.@.@@.@...@.@...@
@@@.@.@@.@.@...@@.@@@@@.@.@@.@.@...@@.@@@@@.@.@@.@.@...@@.@@@@@.@.@@.@.@...@@.@@@@@.@.@@.@.@...@@.@@@@@.@.@@.@.@...@@.@@
@.@.@.@@.@.@.@@@@.@@@.@.@.@@.@.@.@@@@.@@@.@.@.@@.@.@.@@@@.@@@.@.@.@@.@.@.@@@@.@@@.@.@.@@.@.@.@@@@.@@@.@...@@.@.@.@@@@.@@
@.@.@.@@.@.@.@....@@@.@.@.@@.@.@.@....@@@.@.@.@@.@.@.@........@.@.@@.@.@.@....@@@.@.@.@@.@.@.@....@@@.@.@.@@.@.@.@....@@
@...@.@@...@.@.@@.@@@...@.@@...@.@.@@.@@@...@.@@...@.@.@@.@@@...@.@@...@.@.@@.@@@...@.@@...@.@.@@.@@@...@.@@...@.@.@@.@@
@.@@@.@@@@@@.@.@@..@@.@@@.@@@@@@.@.@@..@@.@@@.@@@@@@.@.@@..@@.@@@.@@@@@@.@.@@..@@.@@@.@@@@@@.@.@@..@@.@@@.@@@@@@.@.@@..@
@.@...@@.....@.@@@@@@.@...@@.....@.@@@@@@.@...@@.....@.@@@@@@.@...@@.....@.@@@@@@.@...@@.....@.@@@@@@.@...@@.....@.@@@@@
@.@@@@@..@@@@@@@@@.@@.@@@@@..@@@@@@@@@.@@.@@@@@..@@@@@@@@@.@@.@@@@@..@@@@@@@@@.@@.@@@@@..@@@@@@@@@.@@.@@@@@..@@@@@@@@@.@
@....@@@@@@@....@@.......@@@@@@@....@@.@@....@@@@@@@....@@.@@....@@@@@@@....@@.......@@@@@@@....@@.......@@@@@@@....@@.@
@@@@.......@.@@@@..@@@@@.......@.@@@@..@@@@@.......@.@@@@..@@@@@.......@.@@@@..@@@@@.......@.@@@@..@@@@@.......@.@@@@@.@
@....@@@@@........@@@....@@@@@........@@@....@@@@@........@@@....@@@@@........@@@....@@@@@........@@@....@@@@@.........@
@@@.@@@@@@@@@@@@@@@@@@@@@@@@@@@@@@@@@@@@@.@@@@@@@@@@@@@@@@@@@.@@@@@@@@@@@@@@@@@@@@@@@@@@@@@@@@@@@@@@@@@@@@@@@@@@@@@@@@.@
@.@........@.....@.@@.@........@.....@.@@.@........@.....@....@........@.....@.@@.@........@.....@.@@.@........@.....@.@
@...@.@.@@...@@@...@@...@.@.@@...@@@...@@...@.@.@@...@@@...@@...@.@.@@...@@@...@@...@.@.@@...@@@........@.@.@@...@@@.F.@
@@.@@.@.@@@@@@@@@.@@@@.@@.@.@@@@@@@@@.@@@@.@@.@.@@@@@@@@@.@@@@.@@.@.@@@@@@@@@.@@@@.@@.@.@@@@@@@@@.@@@@.@@.@.@@@@@@@@@.@@
@..@..@.......@@...@@..@..@.......@@...@@..@..@.......@@...@@..@..@.......@@.......@..@.......@@...@@..@..@.......@@...@
@.@@@@@@@@@@.@@@@.@@@.@@@@@@@@@@.@@@@.@@@.@@@@@@@@@@.@@@@.@@@.@@@@@@@@@@.@@@@.@@@.@@@@@@@@@@.@@@@.@@@.@@@@@@@@@@.@@@@.@@
@.....@@.....@.@..........@@.....@.@...@@.....@@.....@.@...@@.@@.........@@@@.@@@.@@@@@@@@@@.@@@@.@@@.@@@@@@@@@@.@@@@.@@
@.@.@.@@.@@@@@.@@.@@@.@.@.@@.@@@@@.@@.@@@.@.@.@@.@@@@@.@@.@@@.@@.@@@@@@@.@@@@.@@@.@@@@@@@@@@.@@@@.@@@.@@@@@@@@@@.@@@@.@@
@.@.@.@@.@...@.@@.@@@.@.@.@@.@...@.@...@@.@.@.@@.@...@.@...@@.@@.......@.@@@@.@@@.@@@@@@@@@@.@@@@.@@@.@@@@@@@@@@.@@@@.@@
@@@.@.@@.@.@...@@...@@@.@.@@.@.@...@@.@@@@@.@.@@.@.@...@@.@@@.@@@@@@@@.@.@@@@.@@@.@@@@@@@@@@.@@@@.@@@.@@@@@@@@@@.@@@@.@@
@.@.@.@@.@.@.@@@@.@.@.@.@.@@.@.@.@@@@.@@@.@.@.@@.@.@.@@@@.@@@.@........@.@@@@.@@@.@@@@@@@@@@.@@@@.@@@.@@@@@@@@@@.@@@@.@@
@.@.@.@@.@.@.@....@.@.@.@.@@.@.@......@@@.@.@.@@.@.@.@....@@@.@.@@@@@@@@.@@@@.@@@.@@@@@@@@@@.@@@@.@@@.@@@@@@@@@@.@@@@.@@
@...@.@@...@.@.@@.@@@...@.@@...@.@.@@.@@@...@.@@...@.@.@@.@@@.@.@.@.@.@@.@@@@.@@@.@@@@@@@@@@.@@@@.@@@.@@@@@@@@@@.@@@@.@@
@.@@@.@@@@@@.@.@@..@@.@@@.@@@@@@.@.@@..@@.@@@.@@@@@@.@.@@..@@.@........@.@@@@.@@@.@@@@@@@@@@.@@@@.@@@.@@@@@@@@@@.@@@@.@@
@.@...@@.....@.@@@@@@.@...@@.....@.@@@.@@.@...@@.....@.@@@@@@.@.@@@@@@@@.@@@@.@@@.@@@@@@@@@@.@@@@.@@@.@@@@@@@@@@.@@@@.@@
@.@@@@@..@@@@@@@@@.@@.@@.@@@.@@@@@@@@@.@@.@@@@@@.@@@@@@@@@.@@.@........@.@@@@.@@@............@@@@.@@@.@@@@@@@@@@.@@@@.@@
@....@@@@@@@....@@.@@.@@.@@@.@@@@@@@@@.@@.@@@@@@.@@@@@@@@@.@@.@.@@@@@@@@.@@@@.@@@.@@@@@@@@@@.@@@@.@@@.@@@@@@@@@@.@@@@.@@
@@@@.......@.@@@@..@@@@@.......@.@@@@..@@@@@.......@.@@@@@.@@.@........@.@@@@.@@@.@@@@@@@@@@.@@@@.@@@.@@@@@@@@@@.@@@@.@@
@....@@@@@........@@@....@@@@@........@@@....@@@@@.........@@@@@.@@@@@@@.@@@@.@@@.@@@@@@@@@@.@@@@.@@@.@@@@@@@@@@.@@@@.@@
@@@@@@@@@@.@@@@@@@@@@@@.@@@@@@@@@@@@@@@@@.@@@@@@@@@@@@@@@@.@@.@@.@@@@@@@.@@@@.@@@.@@@@@@@@@@.@@@@.@@@.@@@@@@@@@@.@@@@.@@
@.@........@.....@.@@.@........@.....@.@@.@........@.....@.@@.@@.@@@@@@@.@@@@.@@@.@@@@@@@@@@.@@@@.@@@.@@@@@@@@@@.@@@@.@@
@...@.@.@@...@@@...@@...@.@.@@...@@@...@@...@.@.@@...@@@...@@.@@.@@@@@@@.@@@@.@@@.@@@@@@@@@@.@@@@.@@@.@@@@@@@@@@.@@@@.@@
@@.@@.@.@@@@@@@@@.@@@@.@@.@.@@@@@@@@@.@@@@.@@.@.@@@@@@@@@.@@@.@@.........@@@@.@@@.@@@@@@@@@@.@@@@.@@@.@@@@@@@@@@.@@@@.@@
@..@..@.......@@...@@..@..@.......@@.......@..@.......@@...@@.@@@@@@@@@@.@@@@.@@@.@@@@@@@@@@.@@@@.@@@.@@@@@@@@@@.@@@@.@@
@.@@@@@@@@@@.@@@@.@@@.@@@@@@@@@@.@@@@.@@@.@@@@@@@@@@.@@@@.@@@.@@@@@@@@@@.@@@@.@@@.@@@@@@@@@@.@@@@.@@@.@@@@@@@@@@.@@@@.@@
@.....@@.....@.@...@@.....@@.....@.@...@@.....@@.....@.@...@@.@@@@@@@@@@.@@@@.@@@.@@@@@@@@@@.@@@@.@@@.@@@@@@@@@@.@@@@.@@
@.@.@.@@.@@@@@.@@.@@@.@.@.@@.@@@@@.@@.@@@.@.@.@@.@@@@@.@@.@@@.@@@@@@@@@@.@@@@.@@@.@@@@@@@@@@.@@@@.@@@.@@@@@@@@@@.@@@@.@@
@.@.@.@@.@...@.@...@@.@.@.@@.@...@.@...@@.@.@.@@.@...@.@...@@.@@@@@@@@@@.@@@@.@@@.@@@@@@@@@@.@@@@.@@@.@@@@@@@@@@.@@@@.@@
@@@.@.@@.@.@...@@.@@@@@.@.@@.@.@...@@.@@@@@.@.@@.@.@...@@.@@@.@@@@@@@@@@.@@@@.@@@.@@@@@@@@@@.@@@@.@@@.@@@@@@@@@@.@@@@.@@
@.@.@.@@.@.@.@@@@.@@@.@.@.@@.@.@.@@@@.@@@.@.@.@@.@.@.@@@@.@@@.@@@@@@@@@@.@@@@.@@@.@@@@@@@@@@.@@@@.@@@.@@@@@@@@@@.@@@@.@@
@.@.@.@@.@.@.@....@@@.@.@.@@.@.@.@....@@@.@.@.@@.@.@.@....@@@.@@@@@@@@@@.@@@@.@@@.@@@@@@@@@@.@@@@.@@@.@@@@@@@@@@.@@@@.@@
@...@.@@...@.@.@@.@@@...@.@@...@.@.@@.@@@...@.@@...@.@.@@.@@@.@@@@@@@@@@.@@@@.@@@.@@@@@@@@@@.@@@@.@@@.@@@@@@@@@@.@@@@.@@
@.@@@.@@@@@@.@.@@..@@.@@@.@@@@@@.@.@@..@@.@@@.@@@@@@.@.@@..@@.@@@@@@@@@@.@@@@.@@@.@@@@@@@@@@.@@@@.@@@.@@@@@@@@@@.@@@@.@@
@.@...@@.....@.@@@@@@.@...@@.....@.@@@@@@.@...@@.....@.@@@@@@.@@@@@@@@@@.@@@@.@@@.@@@@@@@@@@.@@@@.@@@.@@@@@@@@@@.@@@@.@@
@.@@@@@..@@@@@@@@@.@@.@@@@@..@@@@@@@@@.@@.@@@@@..@@@@@@@@@.@@.@@@@@@@@@@.@@@@.@@@.@@@@@@@@@@.@@@@.@@@.@@@@@@@@@@.@@@@.@@
@....@@@@@@@....@@.......@@@@@@@....@@.@@....@@@@@@@....@@.@@.@@@@@@@@@@.@@@@.@@@.@@@@@@@@@@.@@@@.@@@.@@@@@@@@@@.@@@@.@@
@@@@.......@.@@@@..@@@@@.......@.@@@@..@@@@@.......@.@@@@..@@.@@@@@@@@@@.@@@@.@@@.@@@@@@@@@@.@@@@.@@@.@@@@@@@@@@.@@@@.@@
@....@@@@@........@@@....@@@@@........@@@....@@@@@........@@@.@@@@@@@@@@.@@@@.@@@.@@@@@@@@@@.@@@@.@@@............@@@@.@@
@.@.@@@@@@.@.@@@@.@@@.@@@@@@@@@@.@@@@.@@@.@@@@@@@@@@.@@@@.....@@@@@@@@@@.@@@@.@@@......@.@@@.@@@@.@@@.@@@@@@@@@@.@@@@.@@
@.@.@@@@@@.@.@@@@.....@@@@.......@@@@.@@@.@@@@@@@@@@.@@@@.@@@.@@@@@@@@@@.@@@@.@@@.@@@@@@.@@@.@@@@.@@@.@@@@@@@@@@.@@@@.@@
@.@........@.@@@@.@.@.@@@@@@@@@@.@@@@.@@@.@@@@@@@@@@.@@@@.@@@.@@@@@@@@@@.@@@@.@@@........@@@.@@@@.@@@.@@@@@@@@@@.@@@@.@@
@@@@@@@@@@@@@@@@@@@@@@@@@@@@@@@@@@@@@@@@@@@@@@@@@@@@@@@@@@@@@@@@@@@@@@@@@@@@@@@@@@@@@@@@@@@@@@@@@@@@@@@@@@@@@@@@@@@@@@@@
