@@@@@@@@@@@@@@@@@@@@
@.@........@.....@.@
@...@.@.@@...@@@...@
@@.@@.@.@@@@@@.@@.@@
@..@...S...........@
@.@@@@@@@@@@.@@@@.@@
@.....@@.....@.@...@
@.@.@.@@.@@@@@.@@.@@
@.@.@.@@.@...@.@...@
@@@.@.@@.@.@...@@.@@
@.@.@.@@.@.@.@@@@.@@
@.@.@.@@.@.@.@....@@
@...@.@@...@.@.@@.@@
@.@@@.@@@@@@.@.@@..@
@.@...@@.....@.@@@@@
@.@@@@@..@@@@@@@@@.@
@....@@.@@@@....@@.@
@@@@.......@.@@@@..@
@F...@@@@@........@@
@@@@@@@@@@@@@@@@@@@@
