@@@@@@@@@@@@@@@@@@@@@@@@@@@@@@@@@@@@@@@@@@@@@@@@@@@@@@@@@@@@@@@@@@@@@@@@@@@@@@@@@@@@@@@@@@@@@@@@@@@@@@@@@@@@@@@@@@@@@@@@
@.@........@.....@.@@.@........@.....@.@@.@........@.....@.@@.@........@.....@.@@.@........@.....@....@........@.....@.@
@...@.@.@@...@@@...@@...@.@.@@...@@@...@@...@.@.@@...@@@...@@...@.@.@@...@@@...@@...@.@.@@...@@@...@@...@.@.@@...@@@...@
@@.@@.@.@@@@@@@@@.@@@@.@@.@.@@@@@@@@@.@@@@.@@.@.@@@@@@@@@.@@@@.@@.@.@@@.@@@@@.@@@@.@@.@.@@@@@@@@@.@@@@.@@.@.@@@@@@@@@.@@
@..@..@.......@@...@@..@..@S......@@...@@..@..@.......@@...@@..@..@.......@@...@@..@..@.......@@...@@..@..@.......@@...@
@.@@@@@@@@@@.@@@@.@@@.@@@@@@@@@@.@@@@.@@@.@@@@@@@@@@.@@@@.@@@.@@@@@@@@@@.@@@@.@@@.@@@@@@@@@@.@@@@.@@@.@@@@@@@@@@.@@@@.@@
@.....@@.....@.@..........@@.....@.@...@@.....@@.....@.@...@@.....@@.....@.@..........@@.....@.@...@@.....@@.....@.@...@
@.@.@.@@.@@@@@.@@.@@@.@.@.@@.@@@@@.@@.@@@.@.@.@@.@@@@@.@@.@@@.@.@.@@.@@@@@.@@.@@@.@.@.@@.@@@@@.@@.@@@.@.@.@@.@@@@@.@@.@@
@.@.@.@@.@...@.@@.@@@.@.@.@@.@...@.@...@@.@.@.@@.@...@.@...@@.@.@.@@.@...@.@@.@@@.@.@.@@.@...@.@...@@.@.@.@@.@...@.@...@
@@@.@.@@.@.@...@@...@@@.@.@@.@.@...@@.@@@@@.@.@@.@.@...@@.@@@@@.@.@@.@.@...@@...@@@.@.@@.@.@...@@.@@@@@.@.@@.@.@...@@.@@
@.@.@.@@.@.@.@@@@.@.@.@.@.@@.@.@.@@@@.@@@.@.@.@@.@.@.@@@@.@@@.@.@.@@.@.@.@@@@.@.@.@.@.@@.@.@.@@@@.@@@.@.@.@@.@.@.@@@@.@@
@.@.@.@@.@.@......@.@.@.@.@@.@.@.@....@@@.@.@.@@.@.@.@....@@@.@.@.@@.@.@.@....@.@.@.@.@@.@.@.@....@@@.@.@.@@.@.@.@....@@
@...@.@@...@.@.@@.@@@...@.@@...@.@.@@.@@@...@.@@...@.@.@@.@@@...@.@@...@.@.@@.@@@...@.@@...@.@.@@.@@@...@.@@...@.@.@@.@@
@.@@@.@@@@@@.@.@@..@@.@@@.@@@@@@.@.@@..@@.@@@.@@@@@@.@.@@..@@.@@@.@@@@@@.@.@@..@@.@@@.@@@@@@.@.@@..@@.@@@.@@@@@@.@.@@..@
@.@...@@.....@.@@@@@@.@...@@.....@.@@@@@@.@...@@.....@.@@@@@@.@...@@.....@.@@@@@@.@...@@.....@.@@@@@@.@...@@.....@.@@@@@
@.@@@@@..@@@@@@@@@.@@.@@@@@@.@@@@@@@@@.@@.@@@@@@.@@@@@@@@@.@@.@@@@@..@@@@@@@@@.@@.@@@@@@.@@@@@@@@@.@@.@@@@@@.@@@@@@@@@.@
@....@@@@@@@....@@.@@.@@@@@@.@@@@@@@@@.@@.@@@@@@.@...@@@@@.@@....@@@@@@@....@@.@@.@@@@@@.@@@@@.@@@.@@.@@@@@@.@@@@@@@@@.@
@@@@.......@.@@@@..@@@@@.......@.@@@@..@@@@@.......@.@@@@@.@@@@@.......@.@@@@..@@@@@.......@.@.@@...@@@@.......@.@@@@@.@
@....@@@@@........@@@....@@@@@........@@@....@@@@@.........@@....@@@@@........@@@....@@@@@........@......@@@@@.........@
@@@@@@@@@@.@@@@@@@@@@@@@@@@@@@@@.@@@@@@@@.@@@@@@@@@@@@@@@@.@@@@@@@@@@@.@@@@@@@@@@@@@@@@@@@.@@@@@@@@@@@@@@@@@@@@@@@@@@@.@
@.@........@.....@.@@.@........@.....@.@@.@........@.....@.@@.@........@.....@.@@.@........@.....@.@@.@........@.....@.@
@...@.@.@@...@@@...@@...@.@.@@...@@@...@@...@.@.@@...@@@...@@...@.@.@@...@@@...@@...@.@.@@...@@@...@@...@.@.@@...@@@...@
@@.@@.@.@@@@@@@@@.@@@@.@@.@.@@@.@@@@@.@@@@.@@.@.@@@@@@@@@.@@@@.@@.@.@@@@@@@@@.@@@@.@@.@.@@@@@@@@@.@@@@.@@.@.@@@@@@@@@.@@
@..@..@.......@@...@@..@..@.......@@.......@..@.......@@...@@..@..@.......@@...@@..@..@.......@@....@..@..@.......@@...@
@.@@@@@@@@@@.@@@@.@@@.@@@@@@@@@@.@@@@.@@@.@@@@@@@@@@.@@@@.@@@.@@@@@@@@@@.@@@@.@@@.@@@@@@@@@@.@@@@.@@@.@@@@@@@@@@.@@@@.@@
@.....@@.....@.@...@@.....@@.....@.@...@@.....@@.....@.@...@@.....@@.....@.@...@@.....@@.....@.@...@@.....@@.....@.@...@
@.@.@.@@.@@@@@.@@.@@@.@.@.@@.@@@@@.@@.@@@.@.@.@@.@@@@@.@@.@@@.@.@.@@.@@@@@.@@.@@@.@.@.@@.@@@@@.@@.@@@.@.@.@@.@@@@@.@@.@@
@.@.@.@@.@...@.@...@@.@.@.@@.@...@.@...@@.@.@.@@.@...@.@...@@.@.@.@@.@...@.@...@@.@.@.@@.@...@.@...@@.@.@.@@.@...@.@...@
@@@.@.@@.@.@...@@.@@@@@.@.@@.@.@...@@.@@@@@.@.@@.@.@...@@.@@@@@.@.@@.@.@...@@.@@@@@.@.@@.@.@...@@.@@@@@.@.@@.@.@...@@.@@
@.@.@.@@.@.@.@@@@.@@@.@.@.@@.@.@.@@@@.@@@.@.@.@@.@.@.@@@@.@@@.@.@.@@.@.@.@@@@.@@@.@.@.@@.@.@.@@@@.@@@.@...@@.@.@.@@@@.@@
@.@.@.@@.@.@.@....@@@.@.@.@@.@.@.@....@@@.@.@.@@.@.@.@........@.@.@@.@.@.@....@@@.@.@.@@.@.@.@....@@@.@.@.@@.@.@.@....@@
@...@.@@...@.@.@@.@@@...@.@@...@.@.@@.@@@...@.@@...@.@.@@.@@@...@.@@...@.@.@@.@@@...@.@@...@.@.@@.@@@...@.@@...@.@.@@.@@
@.@@@.@@@@@@.@.@@..@@.@@@.@@@@@@.@.@@..@@.@@@.@@@@@@.@.@@..@@.@@@.@@@@@@.@.@@..@@.@@@.@@@@@@.@.@@..@@.@@@.@@@@@@.@.@@..@
@.@...@@.....@.@@@@@@.@...@@.....@.@@@@@@.@...@@.....@.@@@@@@.@...@@.....@.@@@@@@.@...@@.....@.@@@@@@.@...@@.....@.@@@@@
@.@@@@@..@@@@@@@@@.@@.@@@@@..@@@@@@@@@.@@.@@@@@..@@@@@@@@@.@@.@@@@@..@@@@@@@@@.@@.@@@@@..@@@@@@@@@.@@.@@@@@..@@@@@@@@@.@
@....@@@@@@@....@@.......@@@@@@@....@@.@@....@@@@@@@....@@.@@....@@@@@@@....@@.......@@@@@@@....@@.......@@@@@@@....@@.@
@@@@.......@.@@@@..@@@@@.......@.@@@@..@@@@@.......@.@@@@..@@@@@.......@.@@@@..@@@@@.......@.@@@@..@@@@@.......@.@@@@@.@
@....@@@@@........@@@....@@@@@........@@@....@@@@@........@@@....@@@@@........@@@....@@@@@........@@@....@@@@@.........@
@@@.@@@@@@@@@@@@@@@@@@@@@@@@@@@@@@@@@@@@@.@@@@@@@@@@@@@@@@@@@.@@@@@@@@@@@@@@@@@@@@@@@@@@@@@@@@@@@@@@@@@@@@@@@@@@@@@@@@.@
@.@........@.....@.@@.@........@.....@.@@.@........@.....@....@........@.....@.@@.@........@.....@.@@.@........@.....@.@
@...@.@.@@...@@@...@@...@.@.@@...@@@...@@...@.@.@@...@@@...@@...@.@.@@...@@@...@@...@.@.@@...@@@........@.@.@@...@@@...@
@@.@@.@.@@@@@@@@@.@@@@.@@.@.@@@@@@@@@.@@@@.@@.@.@@@@@@@@@.@@@@.@@.@.@@@@@@@@@.@@@@.@@.@.@@@@@@@@@.@@@@.@@.@.@@@@@@@@@.@@
@..@..@.......@@...@@..@..@.......@@...@@..@..@.......@@...@@..@..@.......@@.......@..@.......@@.......@..@.......@@...@
@.@@@@@@@@@@.@@@@.@@@.@@@@@@@@@@.@@@@.@@@.@@@@@@@@@@.@@@@.@@@.@@@@@@@@@@.@@@@.@@@.@@@@@@@@@@.@@@@.@@@.@@@...@@@@.@@@@.@@
@.....@@.....@.@..........@@.....@.@...@@.....@@.....@.@...@@.@@.........@@@@.@@@.@@@@@@@@@@.@@@@.@@@.@@@@.@@@@@.@@@@.@@
@.@.@.@@.@@@@@.@@.@@@.@.@.@@.@@@@@.@@.@@@.@.@.@@.@@@@@.@@.@@@.@@.@@@@@@@.@@@@.@@@.@@@@@@@@@@.@@@@.@@@.@@@@.@@@@@.@@@@.@@
@.@.@.@@.@...@.@@.@@@.@.@.@@.@...@.@...@@.@.@.@@.@...@.@...@@.@@.......@.@@@@.@@@.@@@@@@@@@@.@@@@.@@@.@@@@.@@@@@.@@@@.@@
@@@.@.@@.@.@...@@...@@@.@.@@.@.@...@@.@@@@@.@.@@.@.@...@@.@@@.@@@@@@@@.@.@@@@.@@@.@@@@@@@@@@.@@@@.@@@.@@@@.@@@@@.@@@@.@@
@.@.@.@@.@.@.@@@@.@.@.@.@.@@.@.@.@@@@.@@@.@.@.@@.@.@.@@@@.@@@.@........@....@.@@@.@.@@@@@@@@.@@@@.@@@.@@@@...@.@.@@@@.@@
@.@.@.@@.@.@.@....@.@.@.@.@@.@.@......@@@.@.@.@@.@.@.@....@@@.@.@@@@@@@@.@@@@.@@@.@........@.@@@@.@@@.@@@@@@@@@@.@@@@.@@
@...@.@@...@.@.@@.@@@...@.@@...@.@.@@.@@@...@.@@...@.@.@@.@@@.@.@.@.@.@@.@@@@.@@@.@.@@@@@@.@.@@@@.@@@.@@@@@@@@@@.@@@@.@@
@.@@@.@@@@@@.@.@@..@@.@@@.@@@@@@.@.@@..@@.@@@.@@@@@@.@.@@..@@.@........@.@@@@.@@@.@........@.@@@@.@@@.@@@@@@@@@@.@@@@.@@
@.@...@@.....@.@@@@@@.@...@@.....@.@@@.@@.@...@@.....@.@@@@@@.@.@@@@@@@@.@@@@.@@@.@.@@@@@@.@.@@@@.@@@.@@@@@@@@@@.@@@@.@@
@.@@@@@..@@@@@@@@@.@@.@@.@@@.@@@@@@@@@.@@.@@@@@@.@@@@@@@@@.@@.@........@.@@@@.@@@............@@@@.@@@.@..........@@@@.@@
@....@@@@@@@....@@.@@.@@.@@@.@@@@@@@@@.@@.@@@@@@.@@@@@@@@@.@@.@.@@@@@@@@.@@@@.@@@.@.@@@@@.@@.@@@@.@@@.@@@@@@@@@@.@@@@.@@
@@@@.......@.@@@@..@@@@@.......@.@@@@..@@@@@.......@.@@@@@.@@.@........@.@@@@.@@@.@.@@@@@.@@.@@@@.@@@.....@@@....@@@@.@@
@....@@@@@........@@@....@@@@@........@@@....@@@@@.........@@@@@.@@@@@@@.@@@@.@@@.@.@@@@@.@@.@@@@.@@@.@@@@@@@@@@.@@@@.@@
@@@@@@@@@@.@@@@@@@@@@@@.@@@@@@@@@@@@@@@@@.@@@@@@@@@@@@@@@@.@@.@@.@@@@@@@.@....@@@.@.@@@@@@@@.@@@@.@@@.@...............@@
@.@........@.....@.@@.@........@.....@.@@.@........@.....@.@@.@@.@@@@@@@.@@.@.@@@.@.@......@.@@@@.@@@.@@@@@@@.@@.@@@@.@@
@...@.@.@@...@@@...@@...@.@.@@...@@@...@@...@.@.@@...@@@...@@.@@.@@@@@@@.@..@.@@@.@.@.@@@@.@.@@@@.@@@.@@@@@@@.@@.@@@@.@@
@@.@@.@.@@@@@@@@@.@@@@.@@.@.@@@@@@@@@.@@@@.@@.@.@@@@@@@@@.@@@.@@.........@.@@.@@@.@.@.@....@.@@@@.@@@.@@@@@@@.@@.@@@@.@@
@..@..@.......@@...@@..@..@.......@@.......@..@.......@@...@@.@@@@@@@@@@.@..@.@@@.@.@.@@@@@@.@@@@.@@@.@@@@@@@.@@......@@
@.@@@@@@@@@@.@@@@.@@@.@@@@@@@@@@.@@@@.@@@.@@@@@@@@@@.@@@@.@@@.@.......@@.@@.@.@@@.@.@.@@.....@@@@.@@@.@@.@@@@.@@.@@@@.@@
@.....@@.....@.@...@@.....@@.....@.@...@@.....@@.....@.@...@@.@@@@@@@.@@.@..@.@@@.@@@.@@.@@@.@@@@.@@@.@@.@@@@.@@.@@@@.@@
@.@.@.@@.@@@@@.@@.@@@.@.@.@@.@@@@@.@@.@@@.@.@.@@.@@@@@.@@.@@@.@@@@@@@.@@.@@@@.@@@.@@@.@@.@@@.@@@@.@@@.@@.@@@@.@@.@@@@.@@
@.@.@.@@.@...@.@...@@.@.@.@@.@...@.@...@@.@.@.@@.@...@.@...@@.@@@@@@@.@@.@@@@.@@@.@@@..@.....@@@@.@@@.@@.@@@@.@@.@@@@.@@
@@@.@.@@.@.@...@@.@@@@@.@.@@.@.@...@@.@@@@@.@.@@.@.@...@@.@@@.@.@.@.@.@@.@@@@.@@@.@@@@.@@@@@.@@@@.@@@.@@.@@@@.@@.@@@@.@@
@.@.@.@@.@.@.@@@@.@@@.@.@.@@.@.@.@@@@.@@@.@.@.@@.@.@.@@@@.@@@.@........@.@@@@.@@@....@....@@.@..@.@@@.@@.@@@@.@@.@@@@.@@
@.@.@.@@.@.@.@....@@@.@.@.@@.@.@.@....@@@.@.@.@@.@.@.@....@@@.@@.@.@.@.@.@@@@.@@@.@@@@@@@.@@.@.@@.@@@.........@@.@@@@.@@
@...@.@@...@.@.@@.@@@...@.@@...@.@.@@.@@@...@.@@...@.@.@@.@@@.@@@@@@@@.@.@@@@.@@@.@@@.....@@.@..@.@@@.@@@@@@@@@@.@@@@.@@
@.@@@.@@@@@@.@.@@..@@.@@@.@@@@@@.@.@@..@@.@@@.@@@@@@.@.@@..@@.@@@@@@@@.@.@@@@.@@@.@@@.@@@@@@.@@.@.@@@.@@@@@@@@@@.@@@@.@@
@.@...@@.....@.@@@@@@.@...@@.....@.@@@@@@.@...@@.....@.@@@@@@.@........@.@@@@.@@@.@@.....@@@.@..@.@@@.@@@@@@@@@@.@@@@.@@
@.@@@@@..@@@@@@@@@.@@.@@@@@..@@@@@@@@@.@@.@@@@@..@@@@@@@@@.@@.@.@@@@@@@@.@@@@.@@@.@@@@@@.@@@.@.@@.@@@.@.@.@.@.@@.@@@@.@@
@....@@@@@@@....@@.......@@@@@@@....@@.@@....@@@@@@@....@@.@@.@.@@@@@@@@.@@@@.@@@.@@@@@@.....@.@@.@@@.@.@.@.@.@@.@@@@.@@
@@@@.......@.@@@@..@@@@@.......@.@@@@..@@@@@.......@.@@@@..@@.@.@@@@@@@@.@@@@.@@@.@@@@@@@@@@.@..@.@@@.@.@F@.@.@@.@@@@.@@
@....@@@@@........@@@....@@@@@........@@@....@@@@@........@@@.@.@@@@@@@@.@@@@.@@@.@@@@@@@@@@.@@.@.@@@............@@@@.@@
@.@.@@@@@@.@.@@@@.@@@.@@@@@@@@@@.@@@@.@@@.@@@@@@@@@@.@@@@.....@.@@@@@@@@.@@@@.@@@......@.@@@.@@.@.@@@.@@@@@@@@@@.@@@@.@@
@.@.@@@@@@.@.@@@@.....@@@@.......@@@@.@@@.@@@@@@@@@@.@@@@.@@@.@.@@@@@@@@.@@@@.@@@.@@@@@@.@@@.@@.@.@@@.@@@@@@@@@@.@@@@.@@
@.@........@.@@@@.@.@.@@@@@@@@@@.@@@@.@@@.@@@@@@@@@@.@@@@.@@@.@..........@@@@.@@@........@@@....@.@@@.@@@@@@@@@@.@@@@.@@
@@@@@@@@@@@@@@@@@@@@@@@@@@@@@@@@@@@@@@@@@@@@@@@@@@@@@@@@@@@@@@@@@@@@@@@@@@@@@@@@@@@@@@@@@@@@@@@@@@@@@@@@@@@@@@@@@@@@@@@@
