@@@@@@@@@
@S......@
@.@@.@@.@
@.@@@@@F@
@...@@..@
@@@@@@@@@