@@@@@@@@@@
@...S..@.@
@.@.@@@@.@
@.@....@.@
@.@.@@@@.@
@.@..@@..@
@.@@....@@
@.@@.@@@@@
@..@....F@
@@@@@@@@@@
