@@@@@@@@@@@@@@@@@@@@
@.@........@.....@.@
@...@.@.@@...@@@...@
@@.@@.@.@@@@@@@@@.@@
@..@..@S......@@...@
@.@@@@@@@@@@F@@@@.@@
@.....@@.....@.@...@
@.@.@.@@.@@@@@.@@.@@
@.@.@.@@.@...@.@...@
@@@.@.@@.@.@...@@.@@
@.@.@.@@.@.@.@@@@.@@
@.@.@.@@.@.@.@....@@
@...@.@@...@.@.@@.@@
@.@@@.@@@@@@.@.@@..@
@.@...@@.....@.@@@@@
@.@@@@@..@@@@@@@@@.@
@....@@@@@@@....@@.@
@@@@.......@.@@@@..@
@....@@@@@........@@
@@@@@@@@@@.@@@@@@@@@
@.@........@.....@.@
@...@.@.@@...@@@...@
@@.@@.@.@@@@@@@@@.@@
@..@..@.......@@...@
@.@@@@@@@@@@.@@@@.@@
@.....@@.....@.@...@
@.@.@.@@.@@@@@.@@.@@
@.@.@.@@.@...@.@...@
@@@.@.@@.@.@...@@.@@
@.@.@.@@.@.@.@@@@.@@
@.@.@.@@.@.@.@....@@
@...@.@@...@.@.@@.@@
@.@@@.@@@@@@.@.@@..@
@.@...@@.....@.@@@@@
@.@@@@@..@@@@@@@@@.@
@....@@@@@@@....@@.@
@@@@.......@.@@@@..@
@....@@@@@........@@
@@@@@@@@@@@@@@@@@@@@
