@@@@@@@@@@@@@@@@@@@@@@@@@@@@@@@@@@@@@@@@@@@@@@@@@@@@@@@@@@@@@@@@@@@@@@@@@@@@@@@@@@@@@@@@@@@@@@@@@@@@@@@@@@@@@@@@@@@@@@@@
@.@........@.....@.@@.@........@.....@.@@.@........@.....@.@@.@........@.....@.@@.@........@.....@.@@.@........@.....@.@
@...@.@.@@...@@@...@@...@.@.@@...@@@...@@...@.@.@@...@@@...@@...@.@.@@...@@@...@@...@.@.@@...@@@...@@...@.@.@@...@@@...@
@@.@@.@.@@@@@@@@@.@@@@.@@.@.@@@@@@@@@.@@@@.@@.@.@@@@@@@@@.@@@@.@@.@.@@@@@@@@@.@@@@.@@.@.@@@@@@@@@.@@@@.@@.@.@@@@@@@@@.@@
@..@..@.......@@...@@..@..@S......@@...@@..@..@.......@@...@@..@..@.......@@...@@..@..@.......@@...@@..@..@.......@@...@
@.@@@@@@@@@@.@@@@.@@@.@@@@@@@@@@.@@@@.@@@.@@@@@@@@@@.@@@@.@@@.@@@@@@@@@@.@@@@.@@@.@@@@@@@@@@.@@@@.@@@.@@@@@@@@@@.@@@@.@@
@.....@@.....@.@..........@@.....@.@...@@.....@@.....@.@...@@.....@@.....@.@..........@@.....@.@...@@.....@@.....@.@...@
@.@.@.@@.@@@@@.@@.@@@.@.@.@@.@@@@@.@@.@@@.@.@.@@.@@@@@.@@.@@@.@.@.@@.@@@@@.@@.@@@.@.@.@@.@@@@@.@@.@@@.@.@.@@.@@@@@.@@.@@
@.@.@.@@.@...@.@@.@@@.@.@.@@.@...@.@...@@.@.@.@@.@...@.@...@@.@.@.@@.@...@.@@.@@@.@.@.@@.@...@.@...@@.@.@.@@.@...@.@...@
@@@.@.@@.@.@...@@...@@@.@.@@.@.@...@@.@@@@@.@.@@.@.@...@@.@@@@@.@.@@.@.@...@@...@@@.@.@@.@.@...@@.@@@@@.@.@@.@.@...@@.@@
@.@.@.@@.@.@.@@@@.@.@.@.@.@@.@.@.@@@@.@@@.@.@.@@.@.@.@@@@.@@@.@.@.@@.@.@.@@@@.@.@.@.@.@@.@.@.@@@@.@@@.@.@.@@.@.@.@@@@.@@
@.@.@.@@.@.@.@....@.@.@.@.@@.@.@.@....@@@.@.@.@@.@.@.@....@@@.@.@.@@.@.@.@....@.@.@.@.@@.@.@.@....@@@.@.@.@@.@.@.@....@@
@...@.@@...@.@.@@.@@@...@.@@...@.@.@@.@@@...@.@@...@.@.@@.@@@...@.@@...@.@.@@.@@@...@.@@...@.@.@@.@@@...@.@@...@.@.@@.@@
@.@@@.@@@@@@.@.@@..@@.@@@.@@@@@@.@.@@..@@.@@@.@@@@@@.@.@@..@@.@@@.@@@@@@.@.@@..@@.@@@.@@@@@@.@.@@..@@.@@@.@@@@@@.@.@@..@
@.@...@@.....@.@@@@@@.@...@@.....@.@@@@@@.@...@@.....@.@@@@@@.@...@@.....@.@@@@@@.@...@@.....@.@@@@@@.@...@@.....@.@@@@@
@.@@@@@..@@@@@@@@@.@@.@@@@@@.@@@@@@@@@.@@.@@@@@@.@@@@@@@@@.@@.@@@@@..@@@@@@@@@.@@.@@@@@@.@@@@@@@@@.@@.@@@@@@.@@@@@@@@@.@
@....@@@@@@@....@@.@@.@@@@@@.@@@@@@@@@.@@.@@@@@@.@@@@@@@@@.@@....@@@@@@@....@@.@@.@@@@@@.@@@@@@@@@.@@.@@@@@@.@@@@@@@@@.@
@@@@.......@.@@@@..@@@@@.......@.@@@@..@@@@@.......@.@@@@@.@@@@@.......@.@@@@..@@@@@.......@.@@@@..@@@@@.......@.@@@@@.@
@....@@@@@........@@@....@@@@@........@@@....@@@@@.........@@....@@@@@........@@@....@@@@@........@@@....@@@@@.........@
@@@@@@@@@@.@@@@@@@@@@@@@@@@@@@@@@@@@@@@@@@@@@@@@@@@@@@@@@@.@@@@@@@@@@@.@@@@@@@@@@@@@@@@@@@@@@@@@@@@@@@@@@@@@@@@@@@@@@@.@
@.@........@.....@.@@.@........@.....@.@@.@........@.....@.@@.@........@.....@.@@.@........@.....@.@@.@........@.....@.@
@...@.@.@@...@@@...@@...@.@.@@...@@@...@@...@.@.@@...@@@...@@...@.@.@@...@@@...@@...@.@.@@...@@@...@@...@.@.@@...@@@.F.@
@@.@@.@.@@@@@@@@@.@@@@.@@.@.@@@@@@@@@.@@@@.@@.@.@@@@@@@@@.@@@@.@@.@.@@@@@@@@@.@@@@.@@.@.@@@@@@@@@.@@@@.@@.@.@@@@@@@@@.@@
@..@..@.......@@...@@..@..@.......@@.......@..@.......@@...@@..@..@.......@@...@@..@..@.......@@....@..@..@.......@@...@
@.@@@@@@@@@@.@@@@.@@@.@@@@@@@@@@.@@@@.@@@.@@@@@@@@@@.@@@@.@@@.@@@@@@@@@@.@@@@.@@@.@@@@@@@@@@.@@@@.@@@.@@@@@@@@@@.@@@@.@@
@.....@@.....@.@...@@.....@@.....@.@...@@.....@@.....@.@...@@.....@@.....@.@...@@.....@@.....@.@...@@.....@@.....@.@...@
@.@.@.@@.@@@@@.@@.@@@.@.@.@@.@@@@@.@@.@@@.@.@.@@.@@@@@.@@.@@@.@.@.@@.@@@@@.@@.@@@.@.@.@@.@@@@@.@@.@@@.@.@.@@.@@@@@.@@.@@
@.@.@.@@.@...@.@...@@.@.@.@@.@...@.@...@@.@.@.@@.@...@.@...@@.@.@.@@.@...@.@...@@.@.@.@@.@...@.@...@@.@.@.@@.@...@.@...@
@@@.@.@@.@.@...@@.@@@@@.@.@@.@.@...@@.@@@@@.@.@@.@.@...@@.@@@@@.@.@@.@.@...@@.@@@@@.@.@@.@.@...@@.@@@@@.@.@@.@.@...@@.@@
@.@.@.@@.@.@.@@@@.@@@.@.@.@@.@.@.@@@@.@@@.@.@.@@.@.@.@@@@.@@@.@.@.@@.@.@.@@@@.@@@.@.@.@@.@.@.@@@@.@@@.@.@.@@.@.@.@@@@.@@
@.@.@.@@.@.@.@....@@@.@.@.@@.@.@.@....@@@.@.@.@@.@.@.@....@@@.@.@.@@.@.@.@....@@@.@.@.@@.@.@.@....@@@.@.@.@@.@.@.@....@@
@...@.@@...@.@.@@.@@@...@.@@...@.@.@@.@@@...@.@@...@.@.@@.@@@...@.@@...@.@.@@.@@@...@.@@...@.@.@@.@@@...@.@@...@.@.@@.@@
@.@@@.@@@@@@.@.@@..@@.@@@.@@@@@@.@.@@..@@.@@@.@@@@@@.@.@@..@@.@@@.@@@@@@.@.@@..@@.@@@.@@@@@@.@.@@..@@.@@@.@@@@@@.@.@@..@
@.@...@@.....@.@@@@@@.@...@@.....@.@@@@@@.@...@@.....@.@@@@@@.@...@@.....@.@@@@@@.@...@@.....@.@@@@@@.@...@@.....@.@@@@@
@.@@@@@..@@@@@@@@@.@@.@@@@@..@@@@@@@@@.@@.@@@@@..@@@@@@@@@.@@.@@@@@..@@@@@@@@@.@@.@@@@@..@@@@@@@@@.@@.@@@@@..@@@@@@@@@.@
@....@@@@@@@....@@.......@@@@@@@....@@.@@....@@@@@@@....@@.@@....@@@@@@@....@@.......@@@@@@@....@@.......@@@@@@@....@@.@
@@@@.......@.@@@@..@@@@@.......@.@@@@..@@@@@.......@.@@@@..@@@@@.......@.@@@@..@@@@@.......@.@@@@..@@@@@.......@.@@@@@.@
@....@@@@@........@@@....@@@@@........@@@....@@@@@........@@@....@@@@@........@@@....@@@@@........@@@....@@@@@.........@
@@@.@@@@@@@@@@@@@@@@@@@@@@@@@@@@@@@@@@@@@@@@@@@@@@@@@@@@@@@@@@@@@@@@@@@@@@@@@@@@@@@@@@@@@@@@@@@@@@@@@@@@@@@@@@@@@@@@@@.@
@.@........@.....@.@@.@........@.....@.@@.@........@.....@....@........@.....@.@@.@........@.....@.@@.@........@.....@.@
@...@.@.@@...@@@...@@...@.@.@@...@@@...@@...@.@.@@...@@@...@@...@.@.@@...@@@...@@...@.@.@@...@@@........@.@.@@...@@@...@
@@.@@.@.@@@@@@@@@.@@@@.@@.@.@@@@@@@@@.@@@@.@@.@.@@@@@@@@@.@@@@.@@.@.@@@@@@@@@.@@@@.@@.@.@@@@@@@@@.@@@@.@@.@.@@@@@@@@@.@@
@..@..@.......@@...@@..@..@.......@@...@@..@..@.......@@...@@..@..@.......@@.......@..@.......@@...@@..@..@.......@@...@
@.@@@@@@@@@@.@@@@.@@@.@@@@@@@@@@.@@@@.@@@.@@@@@@@@@@.@@@@.@@@.@@@@@@@@@@.@@@@.@@@.@@@@@@@@@@.@@@@.@@@.@@@@@.@@@@.@@@@.@@
@.....@@.....@.@..........@@.....@.@...@@.....@@.....@.@...@@.@@.........@@@@.@@@.@........@.@@@@.@@@.@@@@@.@@.@.@@@@.@@
@.@.@.@@.@@@@@.@@.@@@.@.@.@@.@@@@@.@@.@@@.@.@.@@.@@@@@.@@.@@@.@@.@@@@@@@.@@@@.@@@.@.@@.@.@.@.@@@@.@@@.@@@@@.@@.@.@@@@.@@
@.@.@.@@.@...@.@@.@@@.@.@.@@.@...@.@...@@.@.@.@@.@...@.@...@@.@@.......@.@@@@.@@@.@@@@.@@@@@.@@@@.@@@.@.....@@.@.@@@@.@@
@@@.@.@@.@.@...@@...@@@.@.@@.@.@...@@.@@@@@.@.@@.@.@...@@.@@@.@@@@@@@@.@.@@@@.@@@.@@.........@@@@.@@@.@.@@@@@@.@.@@@@.@@
@.@.@.@@.@.@.@@@@.@.@.@.@.@@.@.@.@@@@.@@@.@.@.@@.@.@.@@@@.@@@.@........@.@@@@.@@@.@@@@@@@@@@.@@@@.@@@.@.@......@.@@@@.@@
@.@.@.@@.@.@.@....@.@.@.@.@@.@.@.@....@@@.@.@.@@.@.@.@....@@@.@.@@@@@@@@.@@@@.@@@.@@@@@@@@@@.@@@@.@@@.@.@@@@.@@@.@@@@.@@
@...@.@@...@.@.@@.@@@...@.@@...@.@.@@.@@@...@.@@...@.@.@@.@@@.@.@.@.@.@@.@@@@.@@@.@@.....@@@.@@@@.@@@.@......@@@.@@@@.@@
@.@@@.@@@@@@.@.@@..@@.@@@.@@@@@@.@.@@..@@.@@@.@@@@@@.@.@@..@@.@........@.@@@@.@@@.@@@@.@@@@@.@@@@.@@@.@@@@.@@@@@.@@@@.@@
@.@...@@.....@.@@@@@@.@...@@.....@.@@@@@@.@...@@.....@.@@@@@@.@.@@@@@@@@.@@@@.@@@.@@@@.@@@@@.@@@@.@@@.@@@@.@@@@@.@@@@.@@
@.@@@@@..@@@@@@@@@.@@.@@@@@@.@@@@@@@@@.@@.@@@@@@.@@@@@@@@@.@@.@........@.@@@@.@@@.@..........@@@@.@@@.@@@@.@@@@@.@@@@.@@
@....@@@@@@@....@@.@@.@@@@@@.@@@@@@@@@.@@.@@@@@@.@@@@@@@@@.@@.@.@@@@@@@@.@@@@.@@@.@@@@@@@@@@.@@@@.@@@.@@@@.@@@@@.@@@@.@@
@@@@.......@.@@@@..@@@@@.......@.@@@@..@@@@@.......@.@@@@@.@@.@........@.@@@@.@@@......@@@@@.@@@@.@@@.@@@@.@@@@@.@@@@.@@
@....@@@@@........@@@....@@@@@........@@@....@@@@@.........@@@@@@@@@@@@@.@@@@.@@@.@@@@.@.....@@@@.@@@.@@@@@@@@@@.@@@@.@@
@@@@@@@@@@.@@@@@@@@@@@@@@@@@@@@@@@@@@@@@@@@@@@@@@@@@@@@@@@.@@.@........@.@@@@.@@@.@@@@.@@@@@.@@@@.@@@.@.@@@@@@@@.@@@@.@@
@.@........@.....@.@@.@........@.....@.@@.@........@.....@.@@.@.@@@@@@.@.@@@@.@@@.@@@@.@@@@@.@@@@.@@@.@.@@@.@@@@.@@@@.@@
@...@.@.@@...@@@...@@...@.@.@@...@@@...@@...@.@.@@...@@@...@@.@.@....@.@.@@@@.@@@.@@@@.@@@@@.@@@@.@@@.@.@@@.@@@@.@@@@.@@
@@.@@.@.@@@@@@@@@.@@@@.@@.@.@@@@@@@@@.@@@@.@@.@.@@@@@@@@@.@@@.@.@.@@@@.@.@@@@.@@@.@@@@.@@@@@.@@@@.@@@.@.@@@.@@@@.@@@@.@@
@..@..@.......@@...@@..@..@.......@@.......@..@.......@@...@@.@.@......@.@@@@.@@@.@@@@.@@@@@.@@@@.@@@.@.@@..@@@@.@..@.@@
@.@@@@@@@@@@.@@@@.@@@.@@@@@@@@@@.@@@@.@@@.@@@@@@@@@@.@@@@.@@@.@.@@@@@@@@.@@@@.@@@.@@@@.@@@@@.@@@@.@@@.@..@@.@@@@.@@.@.@@
@.....@@.....@.@...@@.....@@.....@.@...@@.....@@.....@.@...@@.@..........@@@@.@@@.@@@@.@@@@@.@@@@.@@@.@.@@..@@@@.@..@.@@
@.@.@.@@.@@@@@.@@.@@@.@.@.@@.@@@@@.@@.@@@.@.@.@@.@@@@@.@@.@@@.@@@@@@@@@@.@@@@.@@@.@@@@...@@@.@@@@.@@@.@..@@.@@@@.@@.@.@@
@.@.@.@@.@...@.@...@@.@.@.@@.@...@.@...@@.@.@.@@.@...@.@...@@......@@@@@.@@@@.@@@.@@@@@@@@@@.@@@@.@@@.@.@@@.@@@@.@..@.@@
@@@.@.@@.@.@...@@.@@@@@.@.@@.@.@...@@.@@@@@.@.@@.@.@...@@.@@@.@@@@@@@@@@.@@@@.@@@.........@@.@@@@.@@@.@.....@@@@.@@.@.@@
@.@.@.@@.@.@.@@@@.@@@.@.@.@@.@.@.@@@@.@@@.@.@.@@.@.@.@@@@.@@@.@@@@@@@@@@.@@@@.@@@.@.@@@@@@@@.@@@@.@@@.@.@@@@@@@@.@..@.@@
@.@.@.@@.@.@.@....@@@.@.@.@@.@.@.@....@@@.@.@.@@.@.@.@....@@@......@@@@@.@@@@.@@@.@.@@@@@@.@.@....@@@.@.@.....@@.@@.@.@@
@...@.@@...@.@.@@.@@@...@.@@...@.@.@@.@@@...@.@@...@.@.@@.@@@.@.@@@@@@@@.@@@@.@@@.@.@@@@@@.@.@@@@.@@@.@.@@@@@.@@....@.@@
@.@@@.@@@@@@.@.@@..@@.@@@.@@@@@@.@.@@..@@.@@@.@@@@@@.@.@@..@@.@.....@@@@.@@@@.@@@.@.@@@@@@.@.@@@@..@@.@.......@@.@@@@.@@
@.@...@@.....@.@@@@@@.@...@@.....@.@@@@@@.@...@@.....@.@@@@@@.@@@@@@@@@@.@@@@.@@@.@.@@@@@@.@.@@@@.@@..@.@@@@@.@@....@.@@
@.@@@@@..@@@@@@@@@.@@.@@@@@..@@@@@@@@@.@@.@@@@@..@@@@@@@@@.@@.@@@@@@@@@@.@@@@.@@@.@........@.@@@@..@@.@.@.....@@.@@@@.@@
@....@@@@@@@....@@.......@@@@@@@....@@.@@....@@@@@@@....@@.@@...@........@@@@.@@@.@@@@@@@@@@.@....@@..@.@@@@@@@@....@.@@
@@@@.......@.@@@@..@@@@@.......@.@@@@..@@@@@.......@.@@@@..@@.@@@@@@@@@@.@@@@.@@@.@@@@@@@@@@.@@@@.@@@.@.@.....@@.@@@@.@@
@....@@@@@........@@@....@@@@@........@@@....@@@@@........@@@.@@@@@@@@@@.@..@.@@@.@@@@@@@@@@.@@@@.@@@.@.@.@@@@@@....@.@@
@.@@@@@@@@@@.@@@@.@@@.@@@@@@@@@@.@@@@.@@@.@@@@@@@@@@.@@@@..........@@@@@.@.@@.@@@.@........@..@@@.@@@.@.@......@.@@@@.@@
@.@@@@@@@@@@.@@@@.@@@.@@@@@@@@@@.@@@@.@@@.@@@@@@@@@@.@@@@.@@@.@@@@@@@@@@.@..@.@@@.@@@@@@@@.@.@@@@.@@@.@.@.@@@@@@....@.@@
@.@@@@@@@@@@.@@@@.@@@.@@@@@@@@@@.@@@@.@@@.@@@@@@@@@@.@@@@.@@@.@@@@@@@@@@.@@...@@@..........@.@@@@.@@@...@........@@@@.@@
@@@@@@@@@@@@@@@@@@@@@@@@@@@@@@@@@@@@@@@@@@@@@@@@@@@@@@@@@@@@@@@@@@@@@@@@@@@@@@@@@@@@@@@@@@@@@@@@@@@@@@@@@@@@@@@@@@@@@@@@