@@@@@@@
@....F@
@.@@@@@
@...@.@
@.@@@.@
@....S@
@@@@@@@