@@@@@@@@@
@S......@
@.@@.@@.@
@.@@@@@.@
@..F@@..@
@@@@@@@@@