@@@@@@@@@@@@@@@@@@@@@@@@@@@@@@@@@@@@@@@@@@@@@@@@@@@@@@@@@@@@
@.@........@.....@.@@.@........@.....@.@@.@........@.....@.@
@...@.@.@@...@@@...@@...@.@.@@...@@@...@@...@.@.@@...@@@...@
@@.@@.@.@@@@@@@@@.@@@@.@@.@.@@@@@@@@@.@@@@.@@.@.@@@@@@@@@.@@
@..@..@.......@@...@@..@..@S......@@...@@..@..@.......@@...@
@.@@@@@@@@@@.@@@@.@@@.@@@@@@@@@@.@@@@.@@@.@@@@@@@@@@.@@@@.@@
@.....@@.....@.@..........@@.....@.@...@@.....@@.....@.@...@
@.@.@.@@.@@@@@.@@.@@@.@.@.@@.@@@@@.@@.@@@.@.@.@@.@@@@@.@@.@@
@.@.@.@@.@...@.@@.@@@.@.@.@@.@...@.@...@@.@.@.@@.@...@.@...@
@@@.@.@@.@.@...@@...@@@.@.@@.@.@...@@.@@@@@.@.@@.@.@...@@.@@
@.@.@.@@.@.@.@@@@.@.@.@.@.@@.@.@.@@@@.@@@.@.@.@@.@.@.@@@@.@@
@.@.@.@@.@.@.@....@.@.@.@.@@.@.@.@....@@@.@.@.@@.@.@.@....@@
@...@.@@...@.@.@@.@@@...@.@@...@.@.@@.@@@...@.@@...@.@.@@.@@
@.@@@.@@@@@@.@.@@..@@.@@@.@@@@@@.@.@@..@@.@@@.@@@@@@.@.@@..@
@.@...@@.....@.@@@@@@.@...@@.....@.@@@@@@.@...@@.....@.@@@@@
@.@@@@@..@@@@@@@@@.@@.@@@@@@.@@@@@@@@@.@@.@@@@@@.@@@@@@@@@.@
@....@@@@@@@....@@.@@.@@@@@@.@@@@@@@@@.@@.@@@@@@.@@@@@@@@@.@
@@@@.......@.@@@@..@@@@@.......@.@@@@..@@@@@.......@.@@@@@.@
@....@@@@@........@@@....@@@@@........@@@....@@@@@.........@
@@@@@@@@@@.@@@@@@@@@@@@@@@@@@@@@@@@@@@@@@@@@@@@@@@@@@@@@@@.@
@.@........@.....@.@@.@........@.....@.@@.@........@.....@.@
@...@.@.@@...@@@...@@...@.@.@@...@@@...@@...@.@.@@...@@@...@
@@.@@.@.@@@@@@@@@.@@@@.@@.@.@@@@@@@@@.@@@@.@@.@.@@@@@@@@@.@@
@..@..@.......@@...@@..@..@.......@@.......@..@.......@@...@
@.@@@@@@@@@@.@@@@.@@@.@@@@@@@@@@.@@@@.@@@.@@@@@@@@@@.@@@@.@@
@.....@@.....@.@...@@.....@@.....@.@...@@.....@@.....@.@...@
@.@.@.@@.@@@@@.@@.@@@.@.@.@@.@@@@@.@@.@@@.@.@.@@.@@@@@.@@.@@
@.@.@.@@.@...@.@...@@.@.@.@@.@...@.@...@@.@.@.@@.@...@.@...@
@@@.@.@@.@.@...@@.@@@@@.@.@@.@.@...@@.@@@@@.@.@@.@.@...@@.@@
@.@.@.@@.@.@.@@@@.@@@.@.@.@@.@.@.@@@@.@@@.@.@.@@.@.@.@@@@.@@
@.@.@.@@.@.@.@....@@@.@.@.@@.@.@.@....@@@.@.@.@@.@.@.@....@@
@...@.@@...@.@.@@.@@@...@.@@...@.@.@@.@@@...@.@@...@.@.@@.@@
@.@@@.@@@@@@.@.@@..@@.@@@.@@@@@@.@.@@..@@.@@@.@@@@@@.@.@@..@
@.@...@@.....@.@@@@@@.@...@@.....@.@@@@@@.@...@@.....@.@@@@@
@.@@@@@..@@@@@@@@@.@@.@@@@@..@@@@@@@@@.@@.@@@@@..@@@@@@@@@.@
@....@@@@@@@....@@.......@@@@@@@....@@.@@....@@@@@@@....@@.@
@@@@.......@.@@@@..@@@@@.......@.@@@@..@@@@@.......@.@@@@..@
@....@@@@@........@@@....@@@@@........@@@....@@@@@........@@
@@@@@@@@@@@@@@@@@@@@@@@@@@@@@@@@@@@@@@@@@@@@@@@@@@@@@@@@@@@@
